111111
111111
111111
1P0E01
111111
