111111
111111
111111
1P0EC1
111111
